annee; femmes; hommes; etranger; CH; total
2011; 1519; 1085; 556; 2048; 2604
2012; 1555; 1170; 626; 2099; 2725
2013; 1645; 1209; 692; 2162; 2854
2014; 1699; 1270; 734; 2235; 2969
2015; 1735; 1288; 750; 2273; 3023
2016; 1911; 1309; 792; 2428; 3220
2017; 1993; 1375; 858; 2510; 3368
2018; 2112; 1369; 869; 2612; 3481
2019; 2250; 1438; 905; 2783; 3688
2020; 2477; 1506; 979; 3004; 3983
2021; 2578; 1530; 1039; 3069; 4108